Sneh - snow
kazdy - each, every
pohadka - fairytale
lip - better
jak - how
novinka - novelty
hvezda - star
Take - Also
noc - night
pekne - nicely
jenom - Only
pomoc - Help
ucinnost - efficiency
cas - time
Predevsim - Primarily
namet - theme
prestoze - although
napodoba - imitation
princip - principle
svet - world
hlava - head
misto - place
rodina - family
zmena - change
vesmir - universe
slovnik - dictionary
princezna - princess
kun - horse
brusle - skate
zenske - female
nezavislosti - independence
clovek - human
usta - mouth
kralovska - royal
dcera - daughter
fraza - phrase
typ - type
vecer - evening
strom - tree
napad - idea
cestovani - travel
stranka - page
najevo - revealed
ze - that
mezinarodni - international
koprodukce - co-production
pripad - case
pojeti - conception
skoda - damage
scenar - screenplay
jeste - still
unik - escape
